NO maps/subject_map.cub
SO maps/subject_map.cub
WE maps/subject_map.cub
EA maps/subject_map.cub
C 111,18,49
F 54,54,54

1111111
11D1S01
1DD1101
1111111